官方网址	您好，棋牌游的APP网址： www.qpy5.com , H5网页版网址： www.qpy678.com 请您复制链接至浏览器打开即可，欢迎体验最新现金娱乐棋牌，谢谢

下载	您好，棋牌游的APP网址： www.qpy5.com , H5网页版网址：  www.qpy678.com 请您复制链接至浏览器打开即可，欢迎体验最新现金娱乐棋牌，谢谢

怎么下载	您好，棋牌游的APP网址： www.qpy5.com , H5网页版网址：  www.qpy678.com 请您复制链接至浏览器打开即可，欢迎体验最新现金娱乐棋牌，谢谢

下载地址	您好，为了您更好的体验游戏，平台已针对app进行优化升级，请您卸载目前的app重新至官网： www.qpy5.com   下载安装最新的游戏版本，感谢您对棋牌游的支持与关注！

APP下载地址/链接	亲，麻烦您卸载平台APP清除一下浏览器历史缓存，使用备用下载网址: https://qpy999.app/  试试哦

无法下载	您好，麻烦截图一下您提示的页面，以便客服为您快速核实处理哦

页面打不开	您好，麻烦截图一下您提示的页面，以便客服为您快速核实处理哦

账号登不上	您好，麻烦您提供您页面显示错误提示的截图以及您的游戏ID，以便客服为您查询哦，谢谢

下载不好使	您好，麻烦您提供一下您那边显示页面的截图，以便为您处理哦，谢谢！

下载打不开	您好，麻烦您提供一下您那边显示页面的截图，以便为您处理哦，谢谢！

游戏卡	亲亲，麻烦您关闭本平台的后台程序，开启飞行模式后关闭，再重新登陆尝试下哦

打不开游戏	您好，麻烦截图一下您提示的页面，以便客服为您快速核实处理哦

进不去游戏	您好，麻烦截图一下您提示的页面，以便客服为您快速核实处理哦

卡顿	亲亲，麻烦请您重启手机之后，多次开启飞行模式更换4g网络，再重新登录试下哦

点击没反应	您好，麻烦您退出，清除一下缓存，重新下载，我们棋牌游的网址为：www.qpy5.com ,请您点击我们网址至——默认浏览器——进行下载游戏即可，欢迎体验最新现金娱乐棋牌，谢谢

平台维护吗	您好，目前平台正在维护更新页面，请您休息一会再登录游戏哦，给您带来不便希望您多多谅解的呢

68下载	您好，68聊天软件的下载链接为：  6868chat.com ；   www.68chat.com

68下载	您好，若是苹果手机请在下载页面点击【专业版下载（中国大陆地区）】即可下载68APP哦，谢谢

68注册	您好，68聊天软件的下载链接为 : 68chat.com ，请您输入您的手机号获取验证码即可注册哦，谢谢

68添加好友	您好， 请在消息页面右上角点击【+】，添加朋友，搜索一下68账号后添加即可哦

68客服	您好，68聊天软件的下载链接为 : 68chat.com ，注册账号后，请在消息页面右上角点击【+】，添加朋友，搜索添加68账号：qpy888 ，然后发送【账号+视频】给68专员即可哦，谢谢

无法安装游戏	亲亲，麻烦您清除浏览器缓存，使用此网址重新下载尝试哦：www.qpy123.com

IP怎么查	您好，麻烦您复制网址： ip138.com 至浏览器打开然后截图页面提供给客服，谢谢

苹果无法下载68	您好，若是苹果请在下载页面点击【专业版下载（中国大陆地区）】即可下载68APP哦，谢谢

注册没有福利吗？	亲亲，平台目前有【升级账号赠送5彩金】，【对局狂欢】活动哦，您可以点击“活动”查看详情哦，若是其他活动请联系您的上级咨询哦，谢谢

电话彩金？	您好，请您提供一下游戏id，以便客服为您快速处理问题哦，谢谢

收到电话？	您好，请您提供一下游戏id，以便客服为您快速处理问题哦，谢谢

电销彩金	您好，请您提供一下游戏id，以便客服为您快速处理问题哦，谢谢

牌型彩金	您好，请您提供一下游戏ID和牌局号，以便客服为您查询，谢谢

游戏反水都是每天过了凌晨才反的？	您好，若是合伙人身份，游戏返水会于次日早上9点系统统一发放的哦，请您点击报表或者账变核实一下，谢谢

特邀彩金	您好，请问您在哪得知该活动呢？

新人注册有彩金？	亲亲，平台目前有【升级账号赠送5彩金】，【对局狂欢】活动哦，您可以点击“活动”查看详情哦，若是其他活动请联系您的上级咨询哦，谢谢

彩金多少流水出款	您好，请问您咨询的是哪种彩金呢？

首存送多少	您好，请您提供一下游戏ID，以便客服为您快速处理问题哦，谢谢

我还可以申请什么活动	亲亲，平台目前有【升级账号赠送5彩金】，【对局狂欢】活动哦，您可以点击“活动”查看详情哦，若是其他活动请联系您的上级咨询哦，谢谢

我邀请朋友没有彩金吗	您好，若是合伙人身份，您推荐进入您团队游戏，您可以获得对应的佣金哦，请您提供一下ID以便客服为您查询，谢谢

为什么我没有彩金	亲亲，平台目前有【升级账号赠送5彩金】，【对局狂欢】活动，请问您咨询是什么彩金呢？

我拉了人送多少彩金	您好，请您提供一下游戏id，以便客服为您快速处理问题哦，谢谢

有返水吗  您好，请您提供一下游戏id，以便客服为您快速处理问题哦，谢谢
